111111111111111
1000100000000P1
100C1000000E001
111111111111111