1111111111
1P0001C001
10011101C1
10000001E1
1111111111
