111111111111111
1P0C00010000011
101111101000001
100E01100000001
10000000C000001
111111111111111