1111111111111
1P0C000C000E1
1011111000001
1000C110C0001
1111111111111