111111111111
1P00C0000001
100000C00001
1000000000E1
111111111111