1111111111111111
1P0011C001100001
1001100001100001
100000C000000E01
1111111111111111