11111111111111111111
1P000C0000000C000001
10111101011110101011
10100001010000101001
10101111010111101001
10100C00010000001001
10111010110110111011
1000000010000000C0E1
11111111111111111111