1111111111111
1P1C1000C00E1
1010111110001
1010000C10111
1010101010111
100C101000011
1111111111111