111111111111
1P00C0000001
111111111001
1C0000000011
101111111111
100000C00E11
111111111111